ele	as
ke	IandItis
yahae	his/hers
hae	home
hore	that
oilea	he/she
enee	was
bakengsa	for
ka	on
ba	are
le	with
ba	they
ba	be
ka	at
emong	one
bale	have
ena	this
hotloha	from
ka	by
tjhesang	hot
lentswela	word
empa	but
eng	what
babang	some
ke	is
e	it
o	you
kapa	or
oneanale	had
ea	of
ho	to
le	and
kahare	in
re	we
kgona	can
tswaha	out
tseding	other
baneba	were
eleng	which
etsa	do
tsabona	their
nako	time
haeba	if
tla	will
jwang	how
are	said
emongleemong	each
bolella	tell
etsang	do
sete	set
tsetharo	three
batla	want
moya	air
hantle	well
le	also
bapala	play
nyenyane	small
qeta	end
beha	put
lapeng	home
bala	read
letsoho	hand
koung	port
kgolo	large
peleta	spell
eketsa	add
esitale	even
naheng	land
mona	here
lokelaho	must
kgolo	big
phahameng	high
jwalo	such
latela	follow
ketso	act
kehobaneng	why
botsa	ask
banna	men
fetola	change
tsamaile	went
lesedi	light
mofutaofe	kind
theoha	off
lokela	need
ntlo	house
setshwantsho	picture
leka	try
re	us
hape	again
phoofolo	animal
ntlha	point
mme	mother
lefatshe	world
haufi	near
aha	build
nna	self
lefatsheng	earth
ntate	father
lehaeleefe	any
ntjha	new
mosebetsi	work
karolo	part
nka	take
fumana	get
sebaka	place
oileaetsa	made
phela	live
kae	where
kamora	after
kgutlela	goback
nyenyane	little
feela	only
pota	round
motho	man
selemo	year
oileatla	came
bontsa	show
bohle	everyone
molemo	purpose
nna	me
efa	give
rona	our
tlasa	under
lebitso	name
haholo	verymuch
kaho	through
feela	just
foromo	form
polelo	sentence
ekgolo	great
nahana	think
are/kere	say
thusa	help
tlaase	low
mola	line
fapana	differ
lehlakoreng	side
etsahore	cause
haholo	much
bolela	mean
pele	before
falla	move
tokelo	right
moshanyana	boy
tsofetse	old
leeena	too
tshwanang	same
tsohle	all
mono	there
neng	when
hodimo	up
sebedisa	use
yahao	your
tsela	way
ka	about
babangata	many
kanakoeo	then
ba	them
ngola	write
keneketla	would
jwaloka	like
ele	so
tsena	these
nakoetelele	long
etsa	make
nthoe	thing
bona	see
tsepedi	two
onale	has
sheba	look
hape	again
letsatsi	day
hakekakgona	could
tsamaya	go
tloho	come
ileaetsa	did
nomoro	number
modumo	sound
utlwahala	audible
tjhe	no
kahofetisisa	most
batho	people
yaka	mine
ka	over
tseba	know
metsi	water
hofeta	morethan
pitso	call
pele	first
bafe	who
ka	may
fathse	down
lehlakoreng	side
bile	been
honajoale	now
fumana	find
hlooho	head
ema	stand
le	own
leqephengla	page
lokela	should
naha	country
ileafumana	found
araba	answer
sekolong	school
hola	grow
ithuta	study
esantsee	still
ithuta	learn
dimela	plants
sekoahelo	cover
dijo	food
letsatsi	sun
tsenne	four
pakengtsa	between
mmuso	state
boloka	keep
leihlola	eye
mohla	never
hoqetela	last
dumella	let
nahana	thought
torop	city
sefate	tree
tshela	cross
polasing	farm
kathata	hard
qala	start
kanna	might
pale	story
oileabona	saw
hole	far
leoatle	sea
atamela	draw
tlohile	left
morao	late
matha	run
sekewa	don’t
haantse	while
tobetsa	press
haufi	close
bosiu	night
sebele	real
bophelo	life
tsesengkae	few
kaleboea	north
buka	book
phetha	carryout
oileanka	took
saense	science
ja	eat
kamoreng	room
motswalle	friend
ileaqala	began
maikutloa	idea
ditlhapi	fish
thabeng	mountain
ema	stop
hang	once
botlaaseng	base
utlwa	hear
pere	horse
sehilweng	cut
bonnete	certain
shebella	watch
mmala	color
sefahleho	face
patsi	wood
kasehloohong	main
bulehileng	open
bonahalaeka	seem
hammoho	together
elatelang	next
tshweu	white
bana	children
qala	begin
thola	got
tsamaya	walk
mohlala	example
kokobetsa	ease
pampiri	paper
sehlopha	group
kamehla	always
mmino	music
ba	those
kabobedi	both
letshwao	mark
hangata	often
lengolo	letter
hofihlella	until
noka	river
koloi	car
maoto	feet
tlhokomelo	care
bobedi	second
holekane	enough
thota	pack
ngwanana	girl
tloaelehileng	usual
batjha	youngpeople
itokiseditse	ready
kahodimo	above
lehaeleneng	whenever
khubedu	red
lethathamo	list
lehaholejoalo	even though
ikutloa	feel
puo	talk
nonyana	bird
hanghang	soon
mmele	body
ntja	dog
lelapa	family
hotoba	direct
tlohela	leave
pina	song
lekanya	measure
ntlo	house
sehlahiswa	product
botsho	black
khutshwanyane	short
makgetlo	numeral
sehlophasa	class
moya	wind
potso	question
etsahala	happen
feletseng	complete
sekepe	ship
sebakengseo	area
halofo	half
lefika	rock
elehore	inorder
mollo	fire
kaboroa	south
bothata	problem
sengoathoana	piece
oileare	told
oneatseba	knew
feta	pass
hotlohaka	since
holimo	top
yohle	whole
morena	king
seterateng	street
kaintshi	inch
atisa	multiply
haholetho	nothing
nnetehore	ofcourse
dula	stay
lebidi	wheel
feletseng	full
matla	force
putsoa	grey
ntho	object
etsaqeto	decide
hodimoha	surface
tebileng	deep
kgwedi	moon
sehle ke hlekeng	island
maoto	feet
tsamaiso	system
phathahane	busy
teko	test
rekoto	record
sekepe	boat
tloaelehileng	common
kgauta	gold
hokgoneha	possible
sefofane	plane
sebakeng	instead
omileng	dry
ipotsa	wonder
tsheha	laugh
dikete	thousands
dikgwedi tse fetileng	months ago
oileamatha	ran
hlahloba	check
papadi	game
sebopeho	shape
tjhesang	hot
hopola	miss
tlisitse	brought
motjheso	heat
lehlwa	snow
kgathetse	tired
tlisa	bring
ee	yes
hole-hole	distant
tlatsa	fill
kabothabela	east
pente	paint
puo	language
hara	among
yuniti	unit
matla	power
motse	town
ntle	fine
itseng	particular
fofa	fly
howa	fall
lebisa	lead
lla	cry
lefifi	dark
motjhini	machine
hlokomela	note
emaho	wait
moralo	plan
palo	figure
naledi	star
lebokose	box
lebitso	noun
tshimo	field
babang kaofela	the rest
enepahetseng	correct
kgona	beable
boimaba	pound
entswe	done
botle	beauty
kganna	drive
eme	stood
enale	contain
kapelain	front
ruta	teach
beke	week
qetello	final
oileafa	gave
tala	green
kapotlako	quick
ntshe tsa pele	develop
lewatle	ocean
mofuthu	warmth
mahala	free
motsotso	minute
matla	strong
kgethehileng	special
kelello	mind
kamora	behind
hlakileng	clear
mohatla	tail
hlahisa	produce
haelehantle	fact
sebaka	space
utlwile	heard
molemo ka ho fetisisa	best
hora	hour
molemo	better
nnete	true
kanakoya	during
lekgolo	hundred
tsehlano	five
hopola	remember
mohato	step
pele	early
tshwara	hold
kabophirimela	west
fatshe	ground
thahasello	interest
fihlellar	each
kapele	fast
leetsi	verb
bina	sing
mamela	listen
tsetsheletseng	six
tafoleng	table
leeto	travel
nyane	less
hoseng	morning
tseleshome	ten
bonolo	simple
tsemmaloa	several
selumisa se nyesemane	vowel
ho	towards
ntwa	war
phaqama	lay
kgahlanongle	against
mohlala	pattern
yadiehang	slow
setsi	center
rata	love
motho	person
tjhelete	money
sebeletsa	serve
hlaha	appear
tsela	road
mmapa	map
pula	rain
busa	rule
laolang	govern
hula	pull
batang	cold
tsebiso	notice
lentswe	voice
matla	energy
tsoma	hunt
mohlomong	probably
bethe	bed
abuti	brother
lehe	egg
palama	ride
seleng	cell
dumela	believe
mohlomong	perhaps
nka	pick
katshohanyetso	suddenly
bala	count
sekwere	square
lebaka	reason
bolelele	length
emela	represent
bonono	art
taba	subject
sebakeng	region
boholo	size
fapana	vary
rarolla	settle
bua	speak
boima	weight
kakaretso	general
leqhwa	ice
taba	matter
sedikadikwe	circle
para	pair
kenyeletsa	include
arola	divide
senokosalentsoe	syllable
oileaikutlwa	felt
kgolo	grand
bolo	ball
lehahole jwalo	yet
tsokoangka	wave
tlohela	drop
pelo	heart
nna	am
honajwale	present
boima	heavy
tantsha	dance
enjene	engine
boemoba	position
letsoho	arm
bophara	wide
tsamaya ka sekepe	sail
dinthotsebonahalang	material
karoloana	fraction
moru	forest
dula	sit
morabe	race
fensetere	window
boloka	store
lehlabula	summer
terene	train
robala	sleep
bontshahatsa	prove
leoto	leg
hoikwetlisa	exercise
lerako	wall
tshwasa	catch
thabeng	mountain
lakatsa	wish
lehodimo	sky
boto	board
thabo	joy
mariha	winter
adula	sat
engotsweng	written
hlaha	wild
seletswa	instrument
boloka	kept
kgalase	glass
jwang	grass
kgomo	cow
mosebetsi	job
bohale	edge
pontsho	sign
etela	visit
nakongefetileng	past
bonolo	soft
monate	fun
ekganyang	bright
kgase	gas
boemo ba le hodimo	weather
kgwedi	month
dimilione	millions
bere	bear
fihlelaqetellong	finish
thaba	happy
tshepo	hope
palesa	flower
apesa	clothe
emakatsang	strange
tsamaile	gone
kgwebo	trade
modumo	melody
leeto	trip
ofisi	office
fumana	receive
mola	row
molomo	mouth
tobileng	exact
letswao	symbol
seeta	die
bonyane	least
kgathatso	trouble
hlodiha	shout
ntlele	except
oileangola	wrote
peo	seed
modumo	tone
hobasetho	join
fanakamaikutlo	suggest
hlwekileng	clean
kgefu	break
mofumahadi	lady
jareteng	yard
tsoha	rise
mpe	bad
letsa	blow
oli	oil
madi	blood
ama	touch
hola	grew
sente	cent
kopanya	mix
sehlopha	team
terata	wire
ditshenyehelo	cost
lahlehelwa	lost
sootho	brown
apara	wear
serapeng	garden
lekana	equal
oilearomela	sent
kgetha	choose
wela	fell
dumellane	fit
phalla	flow
hlokangleeme	fair
banka	bank
bokella	collect
pholosa	save
laola	control
desimale	decimal
tsebe	ear
emong	else
haholo	quite
qhetsola	break
nyewe	case
mahareng	middle
bolaya	kill
mora	son
letsheng	lake
motsotso	moment
tekanyo	scale
hodimo	loud
selemo	spring
boloka	preserve
ngwana	child
setereiti	straight
selumiswa	consonant
setjhaba	nation
bukantswe	dictionary
lebese	milk
lebelo	speed
mokgwawa	method
patala	pay
dilemo	age
karolo	section
moaparo	dress
leru	cloud
makala	surprise
kgutsitseng	quiet
lejwe	stone
nyenyane	tiny
ehlwa	climb
phodileng	cool
moralo	design
mafutsana	poor
ngata	alot
teko	experiment
tlase	bottom
senotlolo	key
tshepe	iron
hohlokamolekane	single
thupa	stick
bataletseng	flat
mashomeamabedi	twenty
letlalo	skin
pososelos	mile
lesoba	hole
qhomela	jump
lesea	baby
robedi	eight
motseng	village
kopanale	meet
motso	root
reka	buy
phahamisa	raise
rarolla	solve
tshepe	metal
horena	whether
sututsa	push
supa	seven
temana	paragraph
boraro	third
tla	shall
tshwere	held
moriri	hair
hlalosa	describe
pheha	cook
fatshe	floor
ekabae	ither
sephetho	result
thesa	burn
leralleng	hill
bolokehileng	safe
katse	cat
lekgololadilemo	century
nahanaka	consider
mofutawa	type
molao	law
hanyenyane	abit
lebopong la le watle	coast
khopi	copy
poleloana	phrase
kgutsitseng	silent
telele	tall
lehlabathe	sand
mobu	soil
moqolo	roll
motjheso	temperature
monwana	finger
lefapha	industry
bohlokwa	value
ntwa	fight
leshano	lie
otla	beat
thabisa	excite
tlhaho	natural
maikutloa	view
kutlwisiso	sense
motse-moholo	capital
nkeke	won’t
setulo	chair
kotsi	danger
tholwana	fruit
ruile	rich
teteaneng	congested
lesole	soldier
tshebetso	process
sebetsa	operate
tshebetso	practice
thoko	separate
holethata	difficult
ngaka	doctor
kakopo	please
sireletsa	protect
motsheare	afternoon
sejalo	crop
mehlengea kajeno	modern
elemente	element
otla	hit
seithuti	student
sekgutlo	corner
mokga	party
phepelo	supply
eo	whose
fumana	locate
lesale	ring
bothoba	character
dikokoanyana	insect
tshwere	caught
nako	period
bontsha	indicate
seyalemoya	radio
buile	spoke
athomo	atom
batho	humanbeings
histori	histor
motlakase	electricity
lebella	expect
lesapo	bone
seporo	rail
nahana	imagine
fanaka	provide
dumellana	agree
katselaeo	thus
bonolo	gentle
mosadi	woman
motsamaisi	captain
akanya	guess
hlokahala	necessary
bohale	sharp
lepheo	wing
bopa	create
moahelani	neighbor
hlatswa	wash
hoenalehore	rather
bongataboboholo	crowd
poone	corn
bapisa	compare
thothokiso	poem
kgwele	string
tshepe	bell
itshetleha	depend
nama	meat
sidila	rub
tummeng	famous
molapo	stream
tshaba	fear
mahlonga	sight
tshesane	thin
kgutlotharo	triangle
polanete	planet
potlaka	hurry
kasehloohong	chief
kolone	colony
watjhe	clock
yaka	mine
thae	tie
kena	enter
tonakgolo	major
ahloekileng	fresh
batla	search
romela	send
tshehla	yellow
sethunya	gun
dumella	allow
hatisa	print
bafu	thedead
letheba	spot
lehoatateng	desert
sutu	suit
honajoale	current
phahamisa	lift
aema	rose
fihla	arrive
mongahadi	master
pina	track
motswadi	parent
lebopong la le watle	shore
karohano	division
lakane	sheet
ntho	substance
mohau	favor
amahanya	connect
poso	post
qeta	spend
mafura	fat
thabela	glad
pele	original
kabelo	share
seteisheneng	station
ntate	dad
bohobe	bread
laela	instruct
loketseng	proper
bareng	bar
fanaka	offer
karolo	segment
lekgoba	slave
letata	duck
hang-hang	instant
mmarakeng	market
tekanyoe	degree
tlatsa	populate
tsuonyana	chick
yaratehang	dear
sera	enemy
araba	reply
seno	drink
etsahala	occur
tshehetso	support
puo	speech
tlhaho	nature
fapaneng	range
tshisinyo	motion
tsela	path
metsi	liquid
kena	log
honehobolela	meant
meno	teeth
molaleng	neck
oksijene	oxygen
tsoekere	sugar
lefu	death
bottle	beauty
bokgoni	skill
basadi	women
nako	season
tharollo	solution
makenete	magnet
silevera	silver
leboha	thank
yalekala	branch
abapiswa	match
haholo-holo	especially
feie	fig
tshaba	afraid
kgolo	huge
ausi	sister
tshepe	steel
buisana	discuss
pele	forward
tshwanang	similar
tataisa	guide
boiphihlelo	experience
laduma	score
apole	apple
rekil	bought
etetsepele	led
lebala	pitch
seaparo	coat
boima	mass
karete	card
sehlopha	band
thapo	rope
setlankana	slip
hapa	win
lora	dream
mantsiboya	evening
boemo	condition
fepa	feed
sesebedisoa	tool
kakaretso	total
tsamotheo	basic
monko	smell
phuleng	valley
kapa	nor
habedi	double
setulo	seat
tswelapele	continue
thibela	block
chate	chart
katiba	hat
rekisa	sell
katleho	success
khampani	company
tlosa	subtract
ketsahalo	event
itseng	particular
sebetsana	deal
sesa	swim
nako	term
fapaneng	opposite
mosadi	wife
seeta	shoe
mahetla	shoulders
ata	spread
lokisetsa	arrange
kampong	camp
qapa	invent
khothone	cotton
hlaha	born
robong	nine
teraka	truck
lerata	noise
boemongba	level
monyetla	chance
bokella	gather
lebenkele	shop
otlolla	stretch
lahlela	throw
kganya	shine
thepa	property
kholomo	column
molekhule	molecule
kgetha	select
fosahetseng	wrong
pheta-pheta	repeat
hloka	require
sephara	broad
lokisetsa	prepare
letswai	salt
nko	nose
kabongateng	plural
bohale	anger
kleima	claim
khonthinente	continent
